8 0 0 0 0 2 8 0 0 2 8 2 8 2 8 2 8 0 0 2 8 0 0 0 0 0 0 4 0 2
9 2 8 0 2 9 3 8 2 9 3 9 3 6 3 9 3 8 2 9 3 8 0 0 0 0 0 5 2 1
8 7 9 2 1 8 4 3 9 2 8 2 8 7 8 2 8 7 9 0 0 3 8 0 0 0 0 0 7 1
1 9 0 3 9 7 1 8 2 9 3 1 1 6 3 1 1 9 0 4 0 0 3 8 0 0 0 2 1 1
1 8 0 0 2 1 9 3 9 0 0 5 7 1 8 3 9 0 2 9 0 0 0 7 8 0 0 7 1 1
6 3 8 2 9 5 0 0 0 4 0 0 3 1 1 8 0 0 3 8 0 0 4 3 1 8 0 3 1 1
9 0 3 6 0 0 0 4 2 1 8 0 2 1 1 9 0 0 0 5 0 2 9 2 1 1 8 0 3 1
8 0 4 3 8 0 0 3 6 5 3 8 3 1 9 4 0 0 2 8 0 3 8 3 1 1 1 8 0 7
1 10 1 8 5 0 4 2 6 0 0 3 8 5 2 9 0 2 1 1 8 2 1 8 3 1 1 9 2 1
1 8 3 1 8 2 1 1 1 8 0 0 3 1 9 0 4 3 1 1 1 9 3 1 8 3 1 8 3 1
1 1 8 3 1 1 1 1 1 6 0 2 11 5 0 12 1 8 7 1 6 2 11 3 1 8 3 1 8 3
1 1 9 2 1 9 3 9 3 9 2 9 0 2 8 0 3 1 1 9 7 9 2 8 3 9 2 1 9 2
1 9 0 3 9 2 8 4 0 2 6 0 2 1 6 0 0 3 9 2 6 2 1 1 8 0 3 9 2 1
1 8 0 12 8 3 1 6 2 6 5 2 1 1 6 0 2 8 4 3 1 1 1 6 7 10 8 2 1 1
1 1 8 2 6 0 3 1 1 9 2 1 1 1 1 8 3 1 1 8 7 1 1 1 1 8 3 1 1 1
1 1 1 1 1 8 0 3 9 0 3 9 3 6 3 9 0 3 9 3 1 1 9 3 9 3 8 3 1 1
1 1 1 9 7 9 0 0 4 2 8 2 8 5 0 4 0 0 0 0 3 9 0 0 2 8 3 8 7 1
1 1 9 2 9 2 8 2 1 9 3 9 7 8 2 9 2 8 2 8 0 4 4 0 3 9 0 3 1 1
1 9 0 5 0 7 1 1 9 2 8 2 1 1 9 0 3 1 1 1 8 3 9 0 0 2 8 0 3 1
6 2 8 0 2 1 1 9 4 3 1 9 3 6 0 0 0 3 1 1 1 8 0 0 4 7 9 0 2 1
1 9 7 10 9 3 1 8 3 8 7 8 2 9 0 0 0 2 1 1 1 1 8 0 3 9 0 0 3 1
6 2 9 0 0 0 3 1 8 3 9 3 9 0 0 0 2 1 9 3 9 3 9 0 0 4 4 0 0 3
1 9 0 0 0 0 0 3 9 0 0 0 0 0 0 0 3 9 2 10 8 2 8 2 8 7 9 0 0 2
9 0 0 0 0 0 0 0 0 0 0 0 0 0 0 0 0 0 5 0 3 9 3 9 3 9 0 0 0 3
