8 0 0 2 8 2 8 0 4 0 2 8 2 8 0 2 8 2 8 2
1 8 0 3 1 1 1 8 5 2 1 1 9 3 14 1 1 9 3 1
1 9 2 8 3 1 1 9 2 1 1 9 0 2 1 13 1 14 11 3
9 2 9 3 8 3 1 8 3 1 9 0 0 3 1 8 3 1 8 2
8 5 0 2 1 11 3 9 2 9 0 2 8 0 3 9 2 1 1 1
13 8 2 13 1 8 0 2 1 8 0 3 1 8 0 2 1 1 1 1
8 3 9 2 1 9 2 9 3 1 8 2 1 9 2 9 3 1 1 1
9 2 8 3 6 2 1 8 0 3 1 1 9 2 9 2 8 3 1 1
8 3 9 0 7 6 3 9 2 8 3 9 2 9 2 1 1 8 3 1
1 8 0 2 1 1 8 2 1 9 0 2 9 2 1 6 3 9 2 1
1 9 2 9 3 9 3 9 3 8 0 3 8 3 1 1 8 2 1 1
9 2 1 11 4 0 12 11 0 5 0 2 9 2 6 3 1 9 5 3
8 3 9 2 9 0 2 11 0 0 2 9 2 1 1 8 3 8 0 2
13 8 0 3 8 2 9 0 0 2 9 2 9 5 5 5 2 6 2 1
8 3 8 0 3 9 2 8 2 9 2 1 8 0 0 2 1 1 1 1
9 0 7 8 0 2 1 1 1 8 3 9 3 8 0 3 1 1 1 13
8 0 3 9 2 9 3 1 9 7 8 0 2 9 2 8 3 1 9 2
1 8 0 2 1 8 2 9 2 13 9 2 9 2 1 1 11 3 8 3
1 9 2 1 6 3 9 0 3 8 2 6 2 9 3 9 0 0 5 2
9 0 3 9 5 0 0 0 0 3 9 3 9 0 0 0 0 0 0 3